0x401040
0x401044
0x401046
0x401049
0x40104a
0x40104d
0x401051
0x401052
0x401053
0x401056
0x401058
0x40105f
0x401000
0x401004
0x401008
0x40100f
0x401012
0x401016
0x40101a
0x401120
0x401124
0x4010b0
0x4010b7
0x4010be
0x4010c1
0x4010c4
0x4010c8
0x4010cc
0x4010cf
0x4010d2
0x4010e8
0x401126
0x401127
0x40112a
0x40112e
0x401131
0x401135
0x401138
0x40113b
0x401142
0x401149
0x40115c
0x401161
0x401162
0x4010f0
0x4010f4
0x4010fb
0x4010fd
0x4010fe
0x401101
0x401080
0x401087
0x40108e
0x401091
0x4010a8
0x401106
0x40110d
0x40110e
0x401164
0x401168
0x40116c
0x401170
